"filename", "language", "XML", "C#", "comment", "blank", "total"
"c:\Users\evanj\Documents\GitHub\SharpSand\Direction.cs", "C#", 0, 33, 0, 9, 42
"c:\Users\evanj\Documents\GitHub\SharpSand\DrawingTools.cs", "C#", 0, 45, 2, 15, 62
"c:\Users\evanj\Documents\GitHub\SharpSand\Effect.cs", "C#", 0, 12, 0, 4, 16
"c:\Users\evanj\Documents\GitHub\SharpSand\Element.cs", "C#", 0, 53, 9, 17, 79
"c:\Users\evanj\Documents\GitHub\SharpSand\Matrix.cs", "C#", 0, 122, 14, 19, 155
"c:\Users\evanj\Documents\GitHub\SharpSand\Program.cs", "C#", 0, 88, 14, 28, 130
"c:\Users\evanj\Documents\GitHub\SharpSand\RNG.cs", "C#", 0, 13, 3, 4, 20
"c:\Users\evanj\Documents\GitHub\SharpSand\SharpSand.csproj", "XML", 12, 0, 0, 4, 16
"c:\Users\evanj\Documents\GitHub\SharpSand\elements\Gas.cs", "C#", 0, 46, 4, 10, 60
"c:\Users\evanj\Documents\GitHub\SharpSand\elements\Liquid.cs", "C#", 0, 50, 4, 10, 64
"c:\Users\evanj\Documents\GitHub\SharpSand\elements\Powder.cs", "C#", 0, 33, 7, 11, 51
"c:\Users\evanj\Documents\GitHub\SharpSand\elements\Solid.cs", "C#", 0, 15, 0, 5, 20
"c:\Users\evanj\Documents\GitHub\SharpSand\elements\gas\Fire.cs", "C#", 0, 60, 11, 15, 86
"c:\Users\evanj\Documents\GitHub\SharpSand\elements\gas\Smoke.cs", "C#", 0, 16, 0, 4, 20
"c:\Users\evanj\Documents\GitHub\SharpSand\elements\gas\Steam.cs", "C#", 0, 13, 0, 4, 17
"c:\Users\evanj\Documents\GitHub\SharpSand\elements\liquid\Water.cs", "C#", 0, 20, 6, 6, 32
"c:\Users\evanj\Documents\GitHub\SharpSand\elements\powder\Dirt.cs", "C#", 0, 9, 0, 2, 11
"c:\Users\evanj\Documents\GitHub\SharpSand\elements\powder\Ember.cs", "C#", 0, 34, 1, 7, 42
"c:\Users\evanj\Documents\GitHub\SharpSand\elements\powder\Sand.cs", "C#", 0, 9, 0, 2, 11
"c:\Users\evanj\Documents\GitHub\SharpSand\elements\powder\Snow.cs", "C#", 0, 39, 4, 12, 55
"c:\Users\evanj\Documents\GitHub\SharpSand\elements\powder\Soot.cs", "C#", 0, 16, 0, 5, 21
"c:\Users\evanj\Documents\GitHub\SharpSand\elements\solid\Concrete.cs", "C#", 0, 9, 0, 2, 11
"c:\Users\evanj\Documents\GitHub\SharpSand\elements\solid\Ice.cs", "C#", 0, 29, 1, 5, 35
"c:\Users\evanj\Documents\GitHub\SharpSand\elements\solid\Plant.cs", "C#", 0, 52, 0, 9, 61
"Total", "-", 12, 816, 80, 209, 1117